4 4
************
*A---------*
*----------*
*----------*
*----------*
*---------->
*----------*
*----------*
*-------O--*
*----------*
*----------*
*****V******
.