************
*----------*
*----------*
*----------*
*----------*
<----------*
*----------*
*----------*
*----------*
*----------*
*----------*
*****V******
.