*****^******
*----------*
*----------*
*----------*
*----------*
<----------*
*----------*
*----------*
*----------*
*----------*
*----------*
************
.