*****^******
*----------*
*----------*
*----------*
*----------*
*---------->
*----------*
*----------*
*----------*
*----------*
*----------*
************
.